111111111
1C00C00C1
100P01001
100E01001
111111111